WFFFFFFFFFFFFFFFFFFF
FFFFFFFFFFFFFFFFFFFF
FFFFFFFFFFFFFFFFFFFW
WFFFFFFFFFFFFFFFFFFW
WFWWFWWWWWWWWWWWWWFW
WFFFFFFFFFSFFFFFFFFW
FFFFFFFFFFFFFFFFFFFW
FFFFFFFFFFFFFFFFFFFW
FFFFFFFFFFFFFFFFFFFW
FFFFFFFFFFFFFFFFFFFW
FFFFFFFFFFFFFFFFFFFW
FFFFWWWFFFFFFFFFFFFF
FFFFFFFFFFFFFFFFFFFF
FFFFFFFFFFFFFFFFFFFW
FFFFFFFFFFFFFFFFFFWW
