WWWWWWWWWWWWWWWWWWW
WFFFFFFFFWFFFFFFFFW
WFWWFWWWFWFWWWFWWFW
WFWWFWWWFWFWWWFWWFW
WFFFFFFFFFFFFFFFFFW
WFWWFWFWWWWWFWFWWFW
WFFFFWFFFWFFFWFFFFW
WWWWFWWWFWFWWWFWWWW
FFFWFWFFFBFFFWFWFFF
WWWWFWFWWGWWFWFWWWW
LFFFFFFWIPCWFFFFFFR
WWWWFWFWWWWWFWFWWWW
FFFWFWFFFFFFFWFWFFF
WWWWFWFWWWWWFWFWWWW
WFFFFFFFFWFFFFFFFFW
WFWWFWWWFWFWWWFWWFW
WFFWFFFFFSFFFFFWFFW
WWFWFWFWWWWWFWFWFWW
WFFFFWFFFWFFFWFFFFW
WFWWWWWWFWFWWWWWWFW
WFFFFFFFFFFFFFFFFFW
WWWWWWWWWWWWWWWWWWW
