WWWWWWWWWWWWWWWWWWW
WFFFFFFFFWFFFFFFFFW
WFWWFWWWFWFWWWFWWFW
WFWWFWWWFWFWWWFWWFW
WFFFFFFFFFFFFFFFFFW
WFWWFWFWWWWWFWFWWFW
WFFFFWFFFWFFFWFFFFW
WWWWFWWWFWFWWWFWWWW
WWWWFWFFFRFFFWFWWWW
WWWWFWFWWGWWFWFWWWW
WFFFFFFWIPOWFFFFFFF
WWWWFWFWWWWWFWFWWWW
WWWWFWFFFFFFFWFWWWW
WWWWFWFWWWWWFWFWWWW
WFFFFFFFFWFFFFFFFFW
WFWWFWWWFWFWWWFWWFW
WFFWFFFFFSFFFFFWFFW
WWFWFWFWWWWWFWFWFWW
WFFFFWFFFWFFFWFFFFW
WFWWWWWWFWFWWWWWWFW
WFFFFFFFFFFFFFFFFFW
WWWWWWWWWWWWWWWWWWW
