WWWWWWWWWWWWWWWWWWW
WDDDDDDDDWDDDDDDDDW
WXWWDWWWDWDWWWDWWXW
WDWWDWWWDWDWWWDWWDW
WDDDDDDDDDDDDDDDDDW
WDWWDWDWWWWWDWDWWDW
WDDDDWDDDWDDDWDDDDW
WWWWDWWWDWDWWWDWWWW
FFFWDWDDDBDDDWDWFFF
WWWWDWDWWGWWDWDWWWW
LDDDDDDWIPCWDDDDDDR
WWWWDWDWWWWWDWDWWWW
FFFWDWDDDDDDDWDWFFF
WWWWDWDWWWWWDWDWWWW
WDDDDDDDDWDDDDDDDDW
WDWWDWWWDWDWWWDWWDW
WXDWDDDDDSDDDDDWDXW
WWDWDWDWWWWWDWDWDWW
WDDDDWDDDWDDDWDDDDW
WDWWWWWWDWDWWWWWWDW
WDDDDDDDDDDDDDDDDDW
WWWWWWWWWWWWWWWWWWW
